WWIWWWWWWWWWWWWWWWW
W-H-MMMWWWWWWWWWWWW
W-W------J-----WWWW
W-----G----MMM---GW
W--MMM------MMMMM-W
W---F----WWWWWWWWWW
W------G-----MW
WWWWWWWMWWWWWMM
WWW-WWWWWWWWWW
WWW-WWWWWWWWWW
WWW-WWWWWWWWWW
WWWJWWWWWWWWWW
WWW-WWWWWWWWWW
WWW-WWWWWWWWWW
WWW-WWWWWWWWWW
WWW-WWWWWWWWWW
WWWWWWWWWWWWWW