WWIWWWWWWWWWWWWWWWW
W-H-MMMWWWWWWWWWWWW
W-W------A-----WWWW
W-----A----MMM---AW
W--MMM------MMMMM-W
W---B----WWWWWWWWWW
W------B-----MW
WWWWWWWMWWWWWMM
WWW-WWWWWWWWWW
WWW-WWWWWWWWWW
WWW-WWWWWWWWWW
WWWBWWWWWWWWWW
WWW-WWWWWWWWWW
WWW-WWWWWWWWWW
WWW-WWWWWWWWWW
WWW-WWWWWWWWWW
WWWWWWWWWWWWWW