WWWWWWWWWWWWWWWWW
W-H-MMMWWWWWWWWWW
W-W------A-----WWWWWWWW
W-----A----MMM---A----WWW
W--MMM------MMMMM----W
W---B----WWWWWWWWWWWWW
W------B-----MW
WWWWWWWMWWWWWMM
WWW-WWWWWWWWWW
WWW-WWWWWWWWWW
WWW-WWWWWWWWWW
WWWBWWWWWWWWWW
WWW-WWWWWWWWWW
WWW-WWWWWWWWWW
WWW-WWWWWWWWWW
WWW-WWWWWWWWWW
WWWWWWWWWWWWWW