WWWWWWWWWWWWWWWWWWW
W-H-M--G-M-G--M---W
W---M----I----M-J-W
WWMWMWWWWMWWWWMW-WW
W---M------G--M---W
W---M-J--W----M---W
W---M----W----MWWWW
W---MMMWWWWWMMM---W
W-J-M----W----M---W
W---M------F--MWWWW
WMMMMWMWWWWWMWM---W
W---M----W----M---W
W---M-WWWWWWW-M---W
WW-WM----W----MWJWW
W---M----W--F-M---W
W-J-MMMMMMMMMMM---W
W---M---------M---W
WWWWWWWWWWWWWWWWWWW