WWWWWWWWWWWWWWWWWWW
W-H-MMIW-M-F--M---W
W---M--W-M---GM-J-W
WWMWMWMWWMWWWWMW-WW
W-G-M--W-J-MMJMM--W
WMWMM-JW---W--MM--W
W-F-M--M---W--MWWWW
W---MMMMMWWWMMM---W
WMMM-MM-W-M--MMM--W
W---M--W--M---MWWWW
WMMMMWMWWWWWMWM---W
W---M--W-W----M---W
W-J-M-WWWWWWWJMMMMW
WW-WM--W-W----M---W
W---M--W-W--F-M---W
WMMMMMMWMMMMMMMMMMW
W---M--W---G--M---W
WWWWWWWWWWWWWWWWWWW